1111111111111
1CP1C100000C1
11000000110X1
110011E000001
1111111111111
